===================
...-------------.$.
=.-|...........|-.=
=..|.--.---.--.|..=
=.-|..|.| |.||.|-.=
=..|.|.----.--.|..=
=.-|.....|.....|-.=
=..|.|.|.|.|.|.|..=
=.||.|.|.|.|.|.|-.=
=.------.|.-----|.=
=.....%|...|..?...=
=|.-----.|.------.=
=|.|.|...|.|.|.||.=
=......|.|.....|..=
=.---.--...------.=
=.|.|.|..|...|....=
=...|.|-.|.|...|-.=
=.---.--.|.-----|.=
.........;.........
===================
